라스트워 시즌2 보급품 좌표 정리
생성일: 2026. 5. 31. 오전 1:41
기준: 현재 웹앱에 반영된 정적 출처 데이터

================================================================================
출처: CptHedgehog
링크: https://cpt-hedge.com/maps/season-2/supplies
================================================================================

[CptHedgehog 2단계]
보급품 좌표 284개
76,205 77,649 77,839 80,640 81,480 83,543 85,161 85,305 86,779 87,170
90,334 91,194 91,457 92,507 94,528 94,668 96,655 97,690 97,783 99,300
100,367 101,533 102,185 103,334 105,456 105,699 107,318 107,692 108,826 109,358
109,648 110,303 113,464 113,841 115,182 115,785 116,632 116,805 119,685 120,678
121,168 121,848 122,697 122,823 123,348 124,793 124,842 125,153 127,189 127,679
128,334 130,324 130,541 131,209 131,811 132,463 133,353 133,506 137,168 138,208
138,681 139,373 142,538 143,202 143,800 146,209 146,802 147,543 148,677 149,458
153,857 168,88 168,112 172,134 173,123 174,104 176,141 180,873 181,899 185,866
186,103 192,129 192,915 195,133 195,922 197,863 201,892 202,856 208,142 209,876
212,91 215,863 216,850 219,902 220,105 220,888 221,130 222,916 300,893 302,146
311,111 315,141 317,917 324,115 325,128 327,908 331,882 332,75 332,122 332,899
336,880 342,78 343,81 349,850 351,917 355,906 361,891 363,83 365,901 367,889
368,877 369,145 371,855 373,118 373,886 450,875 451,144 453,870 455,862 464,865
472,916 474,901 478,917 484,93 491,112 493,78 498,79 499,909 500,121 505,130
505,918 507,109 513,121 518,122 519,140 521,97 524,859 524,876 527,116 530,904
537,113 539,889 545,864 546,102 625,102 631,894 633,149 636,141 639,877 641,89
641,902 642,882 645,886 646,134 653,893 657,124 664,879 666,101 666,882 667,142
667,854 667,868 669,139 671,75 673,871 676,142 680,106 686,905 687,81 687,142
690,860 693,135 694,864 695,902 776,905 777,891 780,872 785,903 786,891 788,117
789,894 793,82 793,123 795,78 797,144 801,864 802,137 803,916 807,93 807,111
808,145 809,91 809,859 812,871 819,904 822,123 828,137 830,85 832,100 840,873
843,862 846,891 850,798 851,191 851,627 851,837 853,320 853,530 855,197 857,174
860,319 862,847 863,155 864,540 865,360 866,472 867,320 867,638 869,325 870,209
871,460 871,473 872,215 873,339 873,515 874,494 874,637 875,485 876,684 879,635
880,171 880,197 881,838 882,697 884,515 885,204 886,301 886,330 888,176 888,784
893,802 895,490 896,699 897,189 897,841 898,184 899,849 900,664 901,353 901,515
902,317 905,369 905,454 906,327 907,199 907,629 908,688 910,797 911,826 912,665
914,822 915,367 915,641 916,342 916,646 916,650 917,822 917,842 919,459 919,835
920,176 922,533 922,815 923,310

출처 원본 사용표시 0개
  (없음)

[CptHedgehog 3단계]
보급품 좌표 153개
150,431 150,588 152,249 153,393 155,292 157,739 159,730 160,597 169,231 169,273
169,414 169,592 170,231 178,445 179,716 181,237 183,619 186,714 187,582 190,716
191,278 195,600 196,236 197,265 198,445 198,556 199,389 202,701 204,755 205,709
214,247 216,717 220,395 220,399 222,772 226,844 232,218 239,793 255,198 255,224
255,812 255,814 256,212 260,777 261,163 264,158 269,823 272,177 278,222 278,785
281,839 284,193 287,807 291,162 347,850 373,203 384,849 385,156 391,168 393,190
393,201 396,790 399,827 405,199 412,845 420,180 422,221 423,224 423,805 431,208
431,222 431,775 432,780 434,777 435,180 436,805 436,808 441,803 448,844 551,165
555,189 555,829 564,206 569,793 576,797 577,783 579,192 582,224 583,821 586,200
588,834 593,222 593,223 595,846 608,204 613,175 613,806 615,831 624,816 701,793
704,803 706,835 712,808 732,796 740,212 742,163 753,163 759,159 759,840 761,828
767,785 768,799 769,211 770,799 770,815 771,196 773,181 774,199 775,561 776,732
777,717 778,435 779,391 780,376 782,263 785,624 788,760 790,410 791,715 800,433
804,378 804,583 804,612 804,738 805,251 805,576 810,248 810,287 810,396 813,288
816,616 818,297 823,728 827,376 829,701 832,723 833,248 833,601 838,391 838,559
842,388 845,258 847,748

출처 원본 사용표시 0개
  (없음)

[CptHedgehog 4단계]
보급품 좌표 121개
227,465 232,502 233,543 234,307 234,548 237,361 238,518 240,633 246,632 251,321
252,679 254,682 259,462 260,324 261,635 262,536 263,646 265,312 265,688 269,475
281,332 283,507 287,329 287,368 288,639 290,660 293,324 296,649 298,532 299,370
302,231 306,239 309,280 311,709 316,751 317,270 322,747 324,741 327,753 329,250
337,255 346,281 346,760 350,252 352,743 353,701 370,295 371,758 373,735 374,277
450,282 452,264 455,725 459,267 459,719 467,757 472,292 472,722 479,278 486,702
487,724 488,283 495,707 524,722 533,229 539,269 541,245 546,255 547,741 548,766
631,708 631,761 632,266 635,292 636,269 646,290 657,757 658,747 660,729 662,764
664,743 666,286 667,258 667,709 669,230 670,740 680,239 684,700 689,277 695,275
701,462 708,487 709,463 709,651 710,667 713,455 717,636 718,536 719,350 721,681
727,342 727,372 737,372 737,628 738,509 739,460 742,638 748,495 753,670 755,326
758,303 760,540 760,697 763,325 765,311 766,371 769,354 769,660 770,330 770,691
773,508

출처 원본 사용표시 0개
  (없음)

[CptHedgehog 5단계]
보급품 좌표 80개
302,401 304,394 305,608 308,585 324,390 324,599 325,426 329,592 338,555 338,566
339,435 340,382 346,593 350,609 359,388 360,385 363,576 367,431 370,442 372,568
377,368 380,345 396,691 399,367 410,688 412,342 412,679 413,682 418,373 422,301
422,628 426,309 426,628 428,367 428,695 432,651 434,301 439,634 439,638 441,351
551,632 554,319 560,661 566,307 567,625 570,633 572,693 575,698 577,313 578,340
579,320 579,370 588,303 599,334 603,659 619,677 621,347 621,361 622,680 624,697
628,431 634,615 637,388 646,416 653,441 657,376 661,445 664,577 670,570 677,428
678,614 679,574 683,388 684,592 685,611 686,598 687,439 687,571 688,581 689,387

출처 원본 사용표시 0개
  (없음)

[CptHedgehog 6단계]
보급품 좌표 40개
378,469 382,451 384,514 391,515 396,479 402,517 410,489 426,481 436,510 442,508
463,618 472,621 474,391 478,603 483,624 485,415 487,552 491,398 494,415 506,568
508,435 510,601 517,390 517,418 521,551 523,395 530,434 535,594 539,419 547,596
561,464 562,531 564,479 577,525 581,507 594,545 599,507 599,528 600,485 615,474

출처 원본 사용표시 0개
  (없음)

[CptHedgehog 7단계]
보급품 좌표 5개
463,462 463,512 470,544 535,466 535,538

출처 원본 사용표시 0개
  (없음)

================================================================================
출처: 금고
링크: https://docs.google.com/spreadsheets/d/1hE-9zooI2krrEBjOFF0E2Too51ulXqenJTP8GKemtOY/edit?gid=418127067#gid=418127067
================================================================================

[금고 1단계]
보급품 좌표 410개
1,129 1,601 2,284 2,290 2,593 3,859 4,90 4,900 5,117 5,607
5,608 6,885 8,762 9,423 9,858 11,567 14,386 14,726 16,99 16,440
17,562 18,144 20,267 20,731 20,734 23,414 25,391 25,554 27,582 29,90
29,232 30,278 30,909 31,139 31,386 31,878 33,555 33,556 33,761 34,118
34,743 34,907 35,245 35,279 35,702 36,390 36,722 37,253 39,418 39,704
39,755 41,747 42,892 43,397 43,797 43,918 44,886 45,83 45,443 45,603
46,262 47,432 47,433 47,621 48,571 49,560 52,586 53,238 54,561 54,871
55,601 55,867 55,868 56,125 56,767 57,100 57,381 57,871 57,899 57,915
58,889 59,262 59,888 60,379 60,599 61,383 61,420 61,736 63,391 63,623
64,611 66,601 66,706 66,762 66,890 67,294 67,575 67,899 68,391 68,445
68,576 68,614 68,701 70,294 70,576 72,443 72,759 73,270 74,129 74,142
77,310 79,11 81,46 82,28 88,15 97,70 98,979 99,946 102,925 103,925
105,56 105,999 109,51 109,988 113,4 116,17 118,952 122,942 125,44 127,942
128,5 128,39 131,38 139,39 145,36 145,964 148,952 225,48 229,952 229,953
230,51 230,966 232,74 233,961 234,946 239,56 243,974 245,959 250,937 250,938
252,2 256,957 257,937 265,992 267,6 267,53 267,530 269,27 273,11 276,61
278,22 280,39 280,952 281,50 282,0 282,988 282,996 289,54 292,61 292,928
293,5 293,945 297,985 298,72 299,67 299,931 379,969 381,978 381,980 383,943
383,991 387,0 387,939 390,985 395,944 396,60 398,976 402,928 412,975 413,24
413,59 417,7 417,976 424,957 425,55 426,946 429,48 431,0 431,41 431,978
435,11 439,43 448,25 553,939 554,48 556,58 559,31 559,310 562,958 564,973
565,998 567,929 568,967 572,925 574,959 583,942 585,56 589,978 593,29 593,30
593,300 595,948 595,984 596,29 596,59 596,290 596,590 597,932 599,949 601,932
601,990 603,10 603,37 606,962 607,53 611,943 614,24 614,360 619,951 619,995
624,65 624,948 700,13 701,51 704,977 706,58 707,63 708,68 708,990 709,961
709,972 710,953 713,1 715,30 720,985 722,939 724,63 724,630 732,4 732,40
734,440 738,925 739,947 739,972 740,998 741,967 743,960 755,928 755,982 756,999
757,12 757,59 758,1 762,994 763,11 764,979 767,12 767,37 767,370 768,986
771,51 771,510 773,1 774,940 852,40 855,976 857,936 867,6 867,47 867,600
867,931 867,975 868,71 870,970 874,938 875,66 880,11 880,18 882,932 883,62
883,200 883,620 888,69 889,28 896,62 898,981 900,942 902,991 907,972 908,20
908,957 910,957 912,320 913,720 915,230 919,210 920,420 923,986 924,1 924,280
925,289 926,613 929,125 930,774 931,271 931,746 933,123 933,904 934,922 936,595
937,258 937,960 939,562 939,617 939,739 940,569 943,754 944,858 944,904 946,414
947,731 948,131 948,294 948,410 948,616 948,763 949,425 949,599 949,918 950,426
951,284 951,568 952,563 952,714 952,891 953,241 953,876 953,900 956,246 957,406
957,881 958,135 958,573 958,899 959,895 961,556 961,600 961,763 961,879 962,132
964,400 964,569 964,714 964,920 966,144 966,440 969,282 969,598 970,701 971,573
971,858 973,123 973,764 974,736 975,127 975,563 975,723 977,415 978,140 978,437
978,960 979,133 981,414 982,80 983,384 984,103 984,139 984,149 987,862 988,296
990,594 991,282 991,757 992,104 993,146 994,402 997,907 999,121 999,398 999,586

출처 원본 사용표시 8개
298,72 299,67 417,976 431,978 564,973 597,932 601,932 857,936

[금고 2단계]
보급품 좌표 298개
76,205 77,649 77,839 80,640 81,480 83,543 85,161 85,305 86,779 87,170
90,334 91,194 91,457 92,507 94,528 94,668 96,655 97,690 97,783 99,300
100,367 101,533 102,185 103,334 105,456 105,699 107,318 107,692 108,826 109,358
109,648 110,303 113,464 113,841 115,185 115,785 116,632 116,805 119,685 120,678
121,168 121,848 122,697 122,823 123,348 124,793 124,842 125,153 127,189 127,679
128,334 130,324 130,541 131,209 131,811 132,463 133,353 133,506 137,168 138,208
138,681 139,373 141,815 142,187 142,538 143,202 143,800 146,209 146,519 146,802
147,543 148,677 149,458 153,857 168,88 168,112 172,134 173,123 174,104 176,114
176,141 180,873 181,899 185,866 186,103 192,129 192,915 195,133 195,922 197,863
201,892 202,856 208,142 209,876 212,91 215,863 216,850 219,110 219,902 220,105
220,888 221,130 222,916 300,893 302,146 304,88 311,111 314,131 315,141 317,917
324,115 325,128 327,908 330,98 331,882 332,75 332,122 332,899 336,880 342,78
343,81 349,850 351,917 355,906 361,891 363,83 365,901 367,889 368,877 369,145
371,855 373,118 373,886 450,875 451,144 452,148 453,870 455,862 464,865 472,916
474,901 478,917 484,93 488,878 491,112 493,78 498,79 499,909 502,121 505,130
505,918 507,109 513,121 518,122 519,140 524,859 524,876 527,116 530,904 537,113
539,889 545,864 546,102 625,102 631,894 633,149 636,141 639,877 641,89 641,902
642,882 645,886 646,134 653,893 657,124 664,879 666,101 666,882 667,142 667,854
667,868 669,139 671,75 673,871 676,142 680,106 686,905 687,81 687,142 690,860
693,135 694,864 695,902 776,905 777,891 780,872 784,147 785,903 786,891 788,117
789,894 793,82 793,123 795,78 797,144 801,864 802,137 803,916 807,93 807,111
808,145 809,91 809,859 812,871 819,904 822,123 828,137 830,85 832,100 840,873
843,862 846,887 846,891 850,191 850,798 851,627 851,837 853,320 853,530 855,197
857,174 860,319 862,847 863,155 864,193 864,540 865,360 866,472 867,320 867,638
869,325 870,209 871,460 871,473 871,533 872,215 873,339 873,515 874,494 874,637
875,485 876,684 879,635 880,171 880,197 881,838 882,697 884,515 885,204 886,301
886,330 888,176 888,784 893,802 895,490 895,632 896,699 897,189 897,841 898,184
899,849 900,664 901,353 901,515 902,317 905,369 905,454 906,327 907,199 907,629
908,688 910,797 911,826 912,665 914,822 915,367 915,641 916,342 916,646 916,650
917,822 917,842 919,459 919,835 920,176 922,533 922,815 923,310

출처 원본 사용표시 1개
450,875

[금고 3단계]
보급품 좌표 187개
150,431 150,588 152,249 153,393 155,292 157,739 159,730 160,597 169,231 169,273
169,414 169,594 170,231 178,445 179,716 181,237 183,619 186,714 187,582 190,716
191,278 195,600 195,616 196,236 196,238 197,265 198,445 198,556 199,389 202,701
204,755 205,709 214,247 214,265 216,717 218,423 220,395 220,399 222,772 223,581
226,844 232,218 239,793 249,849 250,844 255,198 255,224 255,812 255,814 256,212
260,777 261,163 264,158 269,823 272,177 278,222 278,785 278,787 279,224 281,839
283,192 284,193 287,807 291,162 347,850 373,203 384,849 385,156 391,168 393,190
393,201 393,203 396,790 399,827 405,199 412,845 420,180 422,221 422,223 423,224
423,805 430,208 431,208 431,222 431,775 431,777 432,780 433,778 434,777 435,180
435,780 436,805 436,808 438,998 441,803 448,844 448,862 551,165 555,188 555,829
555,831 564,206 569,793 569,795 576,797 577,783 579,192 582,224 583,821 586,199
586,200 588,834 593,222 593,223 595,846 608,173 608,203 608,204 613,175 613,806
615,831 624,816 655,831 701,793 704,803 706,217 706,835 706,836 712,809 732,796
740,212 742,163 753,163 759,159 759,840 760,162 761,163 761,828 767,785 768,799
769,211 770,799 770,815 771,196 773,181 774,199 775,561 776,732 777,717 778,435
778,436 779,391 780,376 782,263 785,624 788,760 790,410 791,715 800,433 804,378
804,583 804,612 804,738 805,251 805,576 809,248 810,248 810,287 810,396 812,569
813,288 816,616 818,297 821,550 823,726 827,376 829,701 832,723 833,248 833,601
838,391 838,559 839,718 842,388 843,269 845,258 847,748

출처 원본 사용표시 161개
150,431 150,588 153,393 155,292 157,739 159,730 160,597 169,231 169,273 169,414
170,231 178,445 179,716 181,237 183,619 186,714 190,716 191,278 195,600 195,616
196,236 196,238 197,265 198,445 198,556 199,389 202,701 205,709 214,247 214,265
216,717 218,423 220,395 220,399 222,772 223,581 226,844 232,218 239,793 249,849
250,844 255,198 255,224 255,812 255,814 256,212 260,777 261,163 264,158 269,823
272,177 278,222 278,787 279,224 281,839 283,192 284,193 287,807 291,162 373,203
384,849 385,156 391,168 393,190 393,201 393,203 396,790 399,827 405,199 412,845
420,180 422,221 422,223 423,224 423,805 430,208 431,208 431,222 431,775 431,777
433,778 435,180 435,780 436,805 436,808 438,998 441,803 448,844 448,862 551,165
555,188 555,829 564,206 569,793 569,795 576,797 577,783 579,192 582,224 583,821
586,199 586,200 588,834 593,222 593,223 595,846 608,203 608,204 613,175 613,806
615,831 624,816 655,831 701,793 704,803 706,217 706,835 706,836 712,809 732,796
740,212 742,163 753,163 759,159 760,162 761,163 767,785 770,799 771,196 773,181
774,199 775,561 776,732 777,717 778,435 778,436 779,391 780,376 785,624 788,760
790,410 791,715 800,433 804,583 805,251 805,576 809,248 810,248 810,287 812,569
813,288 816,616 823,726 827,376 829,701 832,723 833,601 838,391 838,559 842,388
847,748

[금고 4단계]
보급품 좌표 148개
227,465 232,502 233,543 234,307 234,548 236,305 237,308 238,518 239,560 240,633
246,632 251,321 255,679 259,462 260,324 261,635 262,532 262,536 263,646 265,312
265,688 267,530 267,600 269,475 280,390 281,332 281,500 282,334 283,334 283,503
283,507 285,366 287,329 287,368 288,639 289,540 290,660 293,500 296,649 298,367
298,532 299,370 299,670 302,231 306,239 309,276 309,280 311,709 316,267 316,751
317,270 322,747 324,741 327,753 329,250 337,255 346,281 346,760 347,283 350,252
352,743 353,701 370,295 371,758 372,296 373,735 374,277 452,264 455,725 456,727
459,717 459,719 467,757 472,292 479,278 486,702 487,724 488,283 495,707 524,722
533,229 534,231 539,270 540,271 541,245 546,255 547,741 548,766 614,360 631,761
632,266 635,292 636,269 644,288 646,290 647,292 657,757 658,747 661,729 662,764
663,766 664,743 666,286 667,258 667,706 667,709 669,230 670,740 680,239 684,700
689,277 695,275 701,462 708,487 709,463 709,651 710,667 711,462 713,455 714,453
717,636 718,536 721,681 722,683 723,679 724,630 727,342 737,372 737,628 738,509
739,460 742,638 748,495 753,670 760,540 760,697 762,539 763,325 765,311 766,371
769,354 769,660 770,330 770,691 771,506 771,510 773,508 774,506

출처 원본 사용표시 0개
  (없음)

[금고 5단계]
보급품 좌표 83개
302,401 304,394 305,608 308,585 324,390 324,599 325,426 329,592 338,555 338,566
339,419 339,435 340,382 346,593 350,609 359,388 360,385 363,576 366,433 367,431
370,442 371,444 372,568 377,368 380,342 380,345 396,691 399,367 401,365 410,688
412,342 412,679 413,682 418,374 422,628 426,309 426,628 428,695 432,651 434,301
439,638 441,351 551,632 554,319 566,307 567,625 570,633 572,693 575,698 577,313
578,340 578,370 579,311 579,320 580,368 581,368 588,303 599,334 603,659 619,677
621,347 621,361 622,680 624,697 634,615 653,441 657,376 659,375 661,445 670,570
677,428 679,574 683,388 684,592 685,569 685,611 686,598 686,613 687,439 687,571
687,582 688,581 689,387

출처 원본 사용표시 0개
  (없음)

[금고 6단계]
보급품 좌표 40개
378,469 382,451 384,514 391,515 396,479 402,517 410,489 426,481 436,510 442,508
463,618 472,621 474,391 478,603 483,624 485,415 487,552 491,398 494,415 506,568
508,435 510,601 517,390 517,418 521,551 523,395 530,434 535,594 539,419 547,596
561,464 562,531 564,477 577,525 581,507 594,545 599,507 599,528 600,485 615,474

출처 원본 사용표시 0개
  (없음)
